1111111111111111111111
1000000000000000000011
1P000000000E1111100001
11110111C1111111111111
1111111111111111111111