1111111111111
1001000000C01
1000000011001
1P000111E0001
1111111111111